###########
######    #
######    #
#    G    #
#     #####
#     #   #
#     #   #
#     #   #
#R    #   #
#     #   #
###########
