######################
###########        ###
###########        ###
###########        ###
###########        ###
#                  ###
#                  ###
#          G       ###
#                  ###
#            #########
#            #       #
#            #       #
#            #       #
#            #       #
#            #       #
#            #       #
#            #       #
#  R         #       #
#            #       #
#            #       #
#            #       #
######################
