###########
######   ##
######   ##
#    G   ##
#     #####
#     #   #
#     #   #
#     #   #
#R    #   #
#     #   #
###########
