###########
#####    G#
#         #
#     #####
#     #   #
#     #   #
#     #   #
#     #   #
#R    #   #
#     #   #
###########
