3.3
0.3
###########
######  G##
######   ##
#        ##
#     #####
#     #####
#     #####
#     #####
#R    #####
###########
###########
