3.0
0.15
#####################
#         #       # #
#         #       # #
#         #       # #
###########       # #
#         #G      # #
#         ###     # #
#   ###           # #
#   ###           # #
#   #################
#   ##     #        #
#   ########        #
#          #        #
#          #        #
######     #        #
#          #        #
#  R       #        #
############        #
#          #        #
#          #        #
#####################
