3.0
0.05
##############################################################
#                            #                            ####
#                            #                            ####
#                            #                            ####
#                            #                            ####
#                            #                            ####
#                            #                            ####
#                            #                            ####
#                            #                            ####
#                            #                            ####
#                            #                            ####
##############################                            ####
#                                                         ####
#                      #                                  ####
#                      #                                  ####
#                      #                                  ####
#                      #                                  ####
#                      #          G                       ####
#                      #                                  ####
#                      #                                  ####
#                    ######                               ####
#                                                         ####
#                     ######                              ####
#           #                    #  ##########################
#                                   #                        #
#           ##################      #                        #
#                           ###     #                        #
#                            ####   #                        #
#                              ##   #                        #
#                               #####                        #
#                                   #                        #
#                                   #                        #
#                                   #                        #
#                                   #                        #
#                                   #                        #
#                                   #                        #
#                                   #                        #
#                                   #                        #
#                                   #                        #
#                                   #                        #
#                                   #                        #
#                                   #                        #
#                                   #                        #
#                                   #                      	 #
#                                   #                      	 #
#                                   #                      	 #
#                                   #                      	 #
#        R                          #                      	 #
#                                   #                      	 #
#                                   #                      	 #
#                                   #                      	 #
#####################################                      	 #
#                                   #                      	 #
#                                   #                      	 #
#                                   #                      	 #
#                                   #                      	 #
#                                   #                      	 #
#                                   #                      	 #
#                                   #                      	 #
#                                   #                        #
#                                   #                        #
##############################################################
