3.3
0.15
######################
###########       ####
###########    #  ####
###########    #  ####
###########    #  ####
###########G   #  ####
#         ######  ####
#   ###           ####
#   ###           ####
#   ##################
#   ##################
#   ##################
#          ###########
#          ###########
######     ###########
#          ###########
#  R       ###########
######################
######################
######################
######################
######################
