###########
#    #   ##
######   ##
#    G   ##
#     #####
#     #   #
#     #   #
#     #   #
#R    #   #
#######   #
###########
