3.3
0.30
###########
######   ##
######   ##
#    G   ##
#     #####
#     #####
#  #  #####
####  #####
#R    #####
###########
###########
