2.4
0.3
########
#      #
#   G  #
#      #
#      #
# R    #
#      #
########