1.75
0.25
#######
#     #
#     #
#  #  #
#  #  #
#R # G#
#######