2.1
0.3
########
#  G   #
#  #   #
#      #
#      #
#      #
#R     #
########