1.8
0.3
#######
#    G#
#     #
#     #
#     #
#R    #
#######