6.6
0.3
######################
#                   G#
#       ##    #      #
#   #    #           #
#             ##     #
#   ##    #    #     #
#    #               #
#         ##    ##   #
#          #     #   #
#   ##  #            #
#    #        #  ##  #
#        ##       #  #
#   #     #          #
#              ##    #
#  ##  ##   #   #    #
#       #            #
#   #        ##      #
#            #       #
#   ##   #       #   #
#    #       #       #
#R                   #
######################