12.0
0.30
#########################################
###          ########  ### ###  #     ###
###              ####   #   #   #     ###
###              ####           #    ####
#                   #           #    ####
#                                    ####
#                                    ####
#                   #           #      G#
#                   #####################
#                                       #
#                                       #
#                                       #
#                                       #
#                 #######################
#                 #######################
#                 #######################
#      ######     ######  ###   ###    ##
#      ######     #####   ###   ###    ##
#        ##         #     #     #      ##
##   ########       #     #     #      ##
#       #####                           #
#       #####                           #
#           #                           #
#           #       #####################
#           #       #####################
#####       #       #####################
#####       #       ###   ###   ###    ##
##       ####       ###   ###   ###    ##
##       ####       #     #     #      ##
#############       #     #     #      ##
######      #                           #
######                                  #
#                                       #
#           #                           #
#           #       #####################
#           #       #                   #
#####       #            ###########    #
#####     ###            ###########    #
##        ###       #    ###########    #
##R       ###       #                   #
#########################################
#########################################