10.0
1.0
##########
#       G#
#      ###
######   #
#        #
#   ######
#        #
#####    #
#R       #
##########