10
1.0
##########
#        #
#      G #
#        #
#        #
#        #
#        #
#        #
#R       #
##########