3.0
0.3
##########
#        #
#    G   #
#        #
#        #
#        #
#        #
# R      #
#        #
##########